1111111111111
1E00000000C01
1010110C10101
1010110C10101
1P00000000C01
1111111111111
